Door1,Door2,Door3,Door4,,,,,,,,
b03b99e99i99,b03b99e99i99,b03b99e99i99,b03b99e99i99,b03b99e99i99,b03b99e99i99,b03b99e99i99,b03b99e99i99,b03b99e09i99,b03b99e99i99,b03b99e99i99,b03b99e99i99
b03b99e99i99,b06b99e99i99,b06b99e99i99,b06b99e99i99,b03b99e99i99,b03b99e99i99,b03b99e99i03,b03b99e99i99,b06b99e99i99,b06b99e99i99,b06b99e99i99,b03b99e99i99
b03b99e99i99,b06b99e99i99,b03b99e99i99,b03b99e99i99,b03b99e99i99,b03b99e09i99,b03b99e99i99,b03b99e99i99,b03b99e99i99,b03b99e99i99,b06b99e99i99,b03b99e99i99
b03b99e99i99,b06b99e99i99,b03b99e99i99,b06b99e99i99,b06b99e99i99,b06b99e99i99,b06b99e99i99,b06b99e99i99,b06b99e99i99,b03b99e99i99,b06b99e99i99,b03b99e99i99
b03b99e99i99,b06b99e99i99,b03b99e99i99,b03b99e99i99,b03b99e99i99,b03b99e99i99,b03b99e99i99,b03b99e99i99,b03b99e99i99,b03b99e99i99,b06b99e99i99,b03b99e99i99
b03b99e99i99,b06b99e99i99,b06b99e99i99,b06b99e99i99,b03b99e99i99,b03b99e99i99,b03b99e99i99,b03b99e99i99,b06b99e99i99,b06b99e99i99,b06b99e99i99,b03b99e09i99
b03b99e99i99,b03b99e99i99,b03b99e99i99,b03b99e99i99,b03b99e99i99,b03b99e99i99,b03b99e99i99,b03b99e99i99,b03b99e99i99,b03b99e99i99,b03b99e99i99,b03b99e99i99
,,,,,,,,,,,
,FINISHED?,NO,,,,,,,,,