Door9,Door9,Door9,Door9,,,,,,,,
b08b99e99i99,b08b99e99i99,b09b99e99i99,b08b99e99i99,b08b99e99i99,b08b99e99i99,b08b99e99i99,b08b99e99i99,b08b99e99i99,b08b99e99i99,b08b99e99i99,b08b99e99i99
b08b99e99i99,b08b99e99i99,b09b99e99i99,b08b99e99i99,b08b99e99i99,b99b99e01i99,b99b99e99i99,b99b99e99i99,b99b99e99i99,b99b99e99i99,b08b99e99i99,b08b99e99i99
b08b99e01i99,b08b99e99i99,b09b99e99i99,b08b99e99i99,b08b99e99i99,b99b99e99i07,b99b99e99i99,b99b99e99i99,b99b99e99i99,b99b99e01i99,b08b99e99i99,b08b99e99i99
b08b99e99i99,b08b99e99i99,b09b99e99i99,b08b99e99i99,b08b99e99i99,b08b99e99i99,b08b99e99i99,b08b99e99i99,b09b99e99i99,b08b99e99i99,b08b99e99i99,b08b99e99i99
b08b99e99i99,b99b99e99i99,b09b99e99i99,b99b99e99i99,b99b99e99i99,b99b99e99i99,b99b99e99i99,b99b99e99i99,b09b99e99i99,b99b99e99i99,b08b99e99i99,b08b99e99i99
b08b99e01i99,b99b99e99i99,b09b99e99i99,b99b99e99i99,b99b99e99i99,b99b99e99i99,b99b99e99i99,b99b99e99i99,b09b99e99i99,b99b99e99i99,b08b99e01i99,b08b99e99i99
b08b99e99i99,b08b99e99i99,b08b99e99i99,b08b99e99i99,b08b99e99i99,b08b99e99i99,b08b99e99i99,b08b99e99i99,b08b99e99i99,b08b99e99i99,b08b99e99i99,b08b99e99i99
,,,,,,,,,,,
,FINISHED?,NO,,,,,,,,,