Door1,Door3,Door2,Door5,,,,,,,,
b03b99e99i99,b03b99e99i99,b03b99e99i99,b03b99e99i99,b03b99e99i99,b03b99e99i99,b03b99e99i99,b03b99e99i99,b03b99e09i99,b03b99e99i99,b03b99e99i99,b03b99e99i99
b03b99e99i99,b03b99e99i99,b03b99e99i99,b03b99e99i99,b03b99e99i99,b03b99e99i99,b03b99e99i99,b03b99e09i99,b03b99e99i99,b03b99e99i99,b03b99e99i99,b03b99e99i99
b03b99e99i99,b03b99e99i99,b04b99e99i99,b03b99e99i99,b03b99e99i99,b03b99e99i99,b03b99e99i99,b03b99e99i99,b03b99e99i99,b04b99e99i99,b03b99e99i99,b03b99e99i99
b03b99e99i99,b03b99e99i99,b03b99e99i99,b03b99e99i99,b03b99e99i99,b03b99e99i99,b03b99e99i99,b03b99e99i99,b03b99e99i99,b03b99e99i99,b03b99e99i99,b03b99e99i99
b03b99e99i99,b03b99e99i99,b04b99e99i99,b03b99e99i99,b03b99e99i99,b03b99e99i99,b03b99e99i99,b03b99e99i99,b03b99e09i99,b04b99e99i99,b03b99e99i99,b03b99e99i99
b03b99e99i99,b03b99e99i99,b03b99e99i99,b03b99e99i99,b03b99e99i99,b03b99e99i99,b03b99e99i99,b03b99e99i99,b03b99e99i99,b03b99e99i99,b03b99e99i99,b03b99e99i99
b03b99e99i99,b03b99e99i99,b03b99e99i99,b03b99e99i99,b03b99e99i99,b03b99e99i99,b03b99e99i99,b03b99e99i99,b03b99e99i99,b03b99e99i99,b03b99e99i99,b03b99e99i99
,,,,,,,,,,,
,FINISHED?,NO,,,,,,,,,