Door3,Door2,Door2,Door1,,,,,,,,
b03b99e99i15,b03b99e99i99,b03b99e99i99,b03b99e99i99,b03b99e99i99,b03b99e99i99,b03b99e99i99,b03b99e99i99,b03b99e99i99,b03b99e99i99,b03b99e99i99,b03b99e99i99
b03b99e99i99,b01b99e99i99,b03b99e99i99,b03b99e99i99,b01b99e99i99,b03b99e99i99,b03b99e99i99,b02b99e99i99,b03b99e99i99,b03b99e99i99,b02b99e99i99,b03b99e99i99
b03b99e99i99,b03b99e99i99,b03b99e99i99,b03b99e99i99,b03b99e99i99,b03b99e99i99,b03b99e99i99,b03b99e99i99,b03b99e99i99,b03b99e99i99,b03b99e99i99,b03b99e99i99
b03b99e99i99,b01b99e99i99,b03b99e99i99,b03b99e99i99,b01b99e99i99,b03b99e99i99,b03b99e99i99,b02b99e99i99,b03b99e99i99,b03b99e99i99,b02b99e99i99,b03b99e99i99
b03b99e99i99,b03b99e99i99,b03b99e99i99,b03b99e99i99,b03b99e99i99,b11b99e99i99,b11b99e99i99,b03b99e99i99,b03b99e99i99,b03b99e99i99,b03b99e99i99,b03b99e99i99
b03b99e99i99,b01b99e99i99,b03b99e99i99,b11b99e99i99,b01b99e99i99,b11b99e99i99,b11b99e99i99,b02b99e99i99,b11b99e99i99,b03b99e99i99,b02b99e99i99,b03b99e99i99
b03b99e99i99,b03b99e99i99,b03b99e99i99,b11b99e99i99,b11b99e99i99,b11b99e99i99,b11b99e99i99,b11b99e99i99,b11b99e99i99,b03b99e99i99,b03b99e99i99,b03b99e99i99
,,,,,,,,,,,
,FINISHED?,YES,,,,,,,,,
