Door3,Door1,Door1,Door2,,,,,,,,
b06b99e99i99,b06b99e99i99,b06b99e99i99,b06b99e99i99,b06b99e99i99,b03b99e99i99,b03b99e99i99,b06b99e99i99,b06b99e99i99,b06b99e99i99,b06b99e99i99,b06b99e99i99
b06b99e99i99,b03b99e13i99,b03b99e99i99,b03b99e99i99,b06b99e99i99,b03b99e99i99,b03b99e99i99,b03b99e99i99,b03b99e99i99,b06b99e99i99,b03b99e99i03,b06b99e99i99
b06b99e99i99,b03b99e99i99,b06b99e99i99,b03b99e99i99,b06b99e99i99,b03b99e99i99,b06b99e99i99,b06b99e99i99,b03b99e99i99,b06b99e99i99,b03b99e13i99,b06b99e99i99
b03b99e99i99,b03b99e99i99,b06b99e99i99,b03b99e99i99,b06b99e99i99,b03b99e99i99,b03b99e99i99,b06b99e99i99,b03b99e99i99,b06b99e99i99,b03b99e99i99,b03b99e99i99
b06b99e99i99,b03b99e99i99,b06b99e99i99,b03b99e13i99,b06b99e99i99,b06b99e99i99,b03b99e99i99,b06b99e99i99,b03b99e99i99,b06b99e99i99,b03b99e99i99,b06b99e99i99
b06b99e99i99,b03b99e99i99,b06b99e99i99,b03b99e99i99,b03b99e99i99,b03b99e99i99,b03b99e99i99,b06b99e99i99,b03b99e99i99,b03b99e99i99,b03b99e99i99,b06b99e99i99
b06b99e99i99,b06b99e99i99,b06b99e99i99,b06b99e99i99,b06b99e99i99,b03b99e99i99,b03b99e99i99,b06b99e99i99,b06b99e99i99,b06b99e99i99,b06b99e99i99,b06b99e99i99
,,,,,,,,,,,
,FINISHED?,YES,,,,,,,,,