Door1,Door3,Door1,Door2,,,,,,,,
b03b99e99i99,b03b99e99i99,b03b99e99i99,b03b99e99i99,b03b99e99i99,b03b99e09i99,b03b99e99i99,b03b99e99i99,b03b99e99i99,b03b99e99i99,b03b99e99i99,b03b99e99i99
b03b99e99i99,b06b99e99i99,b06b99e99i99,b06b99e99i99,b03b99e99i99,b03b99e99i99,b03b99e99i03,b03b99e99i99,b06b99e99i99,b06b99e99i99,b06b99e99i99,b03b99e99i99
b03b99e99i99,b06b99e99i99,b03b99e99i99,b03b99e99i99,b03b99e99i99,b03b99e09i99,b03b99e99i99,b03b99e99i99,b03b99e99i99,b03b99e99i99,b06b99e99i99,b03b99e99i99
b03b99e99i99,b06b99e99i99,b03b99e99i99,b06b99e99i99,b06b99e99i99,b06b99e99i99,b06b99e99i99,b06b99e99i99,b06b99e99i99,b03b99e99i99,b06b99e99i99,b03b99e99i99
b03b99e99i99,b06b99e99i99,b03b99e99i99,b03b99e99i99,b03b99e99i99,b03b99e99i99,b03b99e99i99,b03b99e99i99,b03b99e99i99,b03b99e09i99,b06b99e99i99,b03b99e99i99
b03b99e99i99,b06b99e99i99,b06b99e99i99,b06b99e99i99,b03b99e99i99,b03b99e99i99,b03b99e99i99,b03b99e99i99,b06b99e99i99,b06b99e99i99,b06b99e99i99,b03b99e99i99
b03b99e99i99,b03b99e99i99,b03b99e99i99,b03b99e99i99,b03b99e99i99,b03b99e99i99,b03b99e99i99,b03b99e99i99,b03b99e99i99,b03b99e99i99,b03b99e99i99,b03b99e99i99
,,,,,,,,,,,
,FINISHED?,NO,,,,,,,,,