Door5,Door2,Door1,Door1,,,,,,,,
b03b99e99i99,b03b99e99i99,b03b99e99i99,b03b99e99i99,b03b99e99i99,b03b99e99i99,b03b99e99i99,b03b99e99i99,b03b99e99i99,b03b99e99i99,b03b99e99i99,b03b99e99i99
b03b99e99i99,b03b99e99i99,b04b99e99i99,b03b99e99i99,b03b99e99i99,b03b99e99i99,b03b99e99i99,b03b99e01i99,b03b99e99i99,b04b99e99i99,b03b99e99i99,b03b99e99i99
b03b99e99i99,b03b99e99i99,b03b99e99i99,b03b99e99i99,b03b99e99i99,b03b99e99i99,b03b99e99i99,b03b99e99i99,b03b99e99i99,b03b99e99i99,b03b99e01i99,b03b99e99i99
b03b99e99i99,b03b99e99i99,b03b99e99i99,b03b99e99i99,b03b99e99i99,b03b99e01i99,b03b99e99i99,b03b99e99i99,b03b99e99i99,b03b99e99i99,b03b99e99i01,b03b99e01i99
b03b99e99i99,b03b99e99i99,b03b99e99i99,b03b99e99i99,b03b99e99i99,b03b99e99i99,b03b99e01i99,b03b99e99i99,b03b99e99i99,b03b99e99i99,b03b99e99i99,b03b99e99i99
b03b99e99i99,b03b99e99i99,b04b99e99i99,b03b99e99i99,b03b99e99i99,b03b99e99i99,b03b99e99i99,b03b99e99i99,b03b99e99i99,b04b99e99i99,b03b99e99i99,b03b99e99i99
b03b99e99i99,b03b99e99i99,b03b99e99i99,b03b99e99i99,b03b99e99i99,b03b99e99i99,b03b99e99i99,b03b99e99i99,b03b99e99i99,b03b99e99i99,b03b99e99i99,b03b99e99i99
,,,,,,,,,,,
,FINISHED?,NO,,,,,,,,,