Door2,Door2,Door3,Door5,,,,,,,,
b03b99e99i99,b03b99e99i99,b03b99e18i99,b03b99e99i99,b03b99e99i99,b03b99e99i99,b03b99e99i99,b03b99e99i99,b03b99e99i99,b03b99e99i99,b03b99e99i99,b03b99e99i99
b03b99e99i99,b04b99e99i99,b04b99e99i99,b03b99e99i99,b03b99e99i99,b03b99e99i99,b03b99e99i99,b03b99e99i99,b03b99e18i99,b04b99e99i99,b04b99e99i99,b03b99e99i99
b03b99e99i99,b03b99e99i99,b03b99e99i99,b03b99e18i99,b03b99e99i99,b03b99e99i99,b03b99e99i99,b03b99e99i99,b03b99e99i99,b03b99e99i99,b03b99e99i99,b03b99e99i99
b03b99e99i99,b03b99e99i99,b03b99e99i99,b03b99e99i99,b03b99e99i99,b04b99e99i99,b04b99e99i99,b03b99e99i99,b03b99e99i99,b03b99e99i99,b03b99e99i02,b03b99e99i99
b03b99e99i99,b03b99e99i99,b03b99e99i99,b03b99e99i99,b03b99e99i99,b03b99e99i99,b03b99e99i99,b03b99e99i99,b03b99e99i99,b03b99e99i99,b03b99e99i99,b03b99e99i99
b03b99e99i99,b04b99e99i99,b04b99e18i99,b03b99e99i99,b03b99e99i99,b03b99e99i99,b03b99e99i99,b03b99e99i99,b03b99e18i99,b04b99e99i99,b04b99e99i99,b03b99e99i99
b03b99e99i99,b03b99e99i99,b03b99e99i99,b03b99e99i99,b03b99e99i99,b03b99e99i99,b03b99e99i99,b03b99e99i99,b03b99e99i99,b03b99e99i99,b03b99e99i99,b03b99e99i99
,,,,,,,,,,,
,FINISHED?,NO,,,,,,,,,