Door1,Door2,Door3,Door4,,,,,,,,
b10b99e99i01,b10b99e99i02,b10b99e99i03,b10b99e99i04,b10b99e99i05,b10b99e99i06,b10b99e99i07,b10b99e99i08,b10b99e99i09,b10b99e99i10,b10b99e99i11,b10b99e99i12
b10b99e99i13,b10b99e99i14,b10b99e99i99,b10b99e99i99,b10b99e99i99,b10b99e99i99,b10b99e99i99,b10b99e99i99,b10b99e99i99,b10b99e99i99,b10b99e99i99,b10b99e99i99
b10b99e99i99,b10b99e99i99,b10b99e99i99,b10b99e99i99,b10b99e99i99,b10b99e99i99,b10b99e99i99,b10b99e99i99,b10b99e99i99,b10b99e99i99,b10b99e99i99,b10b99e99i99
b10b99e99i99,b10b99e99i99,b10b99e99i99,b10b99e99i99,b10b99e99i99,b10b99e99i99,b10b99e99i99,b10b99e99i99,b10b99e99i99,b10b99e99i99,b10b99e99i99,b10b99e99i99
b10b99e99i99,b10b99e99i99,b10b99e99i99,b10b99e99i99,b10b99e99i99,b10b99e99i99,b10b99e99i99,b10b99e99i99,b10b99e99i99,b10b99e99i99,b10b99e99i99,b10b99e99i99
b10b99e99i99,b10b99e99i99,b10b99e99i99,b10b99e03i99,b10b99e02i99,b10b99e99i99,b10b99e99i99,b10b99e99i99,b10b99e99i99,b10b99e99i99,b10b99e99i99,b10b99e99i99
b10b99e99i99,b10b99e99i99,b10b99e12i99,b10b99e04i99,b10b99e01i99,b10b99e99i99,b10b99e99i99,b10b99e99i99,b10b99e99i99,b10b99e99i99,b10b99e99i99,b10b99e99i99
,,,,,,,,,,,
,FINISHED?,YES,,,,,,,,,