Door1,Door2,Door1,Door1,,,,,,,,
b03b99e99i99,b03b99e99i99,b03b99e99i99,b03b99e99i99,b03b99e99i99,b03b99e99i99,b03b99e99i99,b03b99e99i99,b03b99e99i99,b03b99e99i99,b03b99e99i99,b03b99e99i99
b03b99e99i99,b04b99e99i99,b04b99e99i99,b04b99e99i99,b04b99e99i99,b04b99e99i99,b04b99e99i99,b04b99e99i99,b04b99e99i99,b04b99e99i99,b04b99e99i99,b03b99e99i99
b03b99e99i99,b04b99e99i99,b03b99e99i99,b03b99e99i99,b01b99e99i99,b03b99e99i05,b03b99e99i99,b02b99e99i99,b03b99e99i99,b03b99e99i99,b04b99e99i99,b03b99e99i99
b03b99e99i99,b04b99e99i99,b03b99e99i99,b01b99e99i99,b03b99e99i99,b03b99e99i99,b03b99e99i99,b03b99e99i99,b02b99e99i99,b03b99e99i99,b04b99e99i99,b03b99e99i99
b03b99e99i99,b04b99e99i99,b03b99e99i99,b03b99e99i99,b03b99e99i99,b03b99e99i99,b03b99e99i99,b03b99e99i99,b03b99e99i99,b03b99e99i99,b04b99e99i99,b03b99e99i99
b03b99e99i99,b04b99e99i99,b04b99e99i99,b04b99e99i99,b04b99e99i99,b03b99e99i99,b03b99e99i99,b04b99e99i99,b04b99e99i99,b04b99e99i99,b04b99e99i99,b03b99e99i99
b03b99e99i99,b03b99e99i99,b03b99e99i99,b03b99e99i99,b03b99e99i99,b03b99e99i99,b03b99e99i99,b03b99e99i99,b03b99e99i99,b03b99e99i99,b03b99e99i99,b03b99e99i99
,,,,,,,,,,,
,FINISHED?,NO,,,,,,,,,