Door1,Door2,Door3,Door4,,,,,,,,
b06b99e99i99,b06b99e99i99,b06b99e99i99,b06b99e99i99,b06b99e99i99,b03b99e99i99,b03b99e13i99,b06b99e99i99,b06b99e99i99,b06b99e99i99,b06b99e99i99,b06b99e99i99
b06b99e99i99,b03b99e13i99,b03b99e99i99,b03b99e99i99,b06b99e99i99,b03b99e99i99,b03b99e99i99,b03b99e99i99,b03b99e99i99,b06b99e99i99,b03b99e99i99,b06b99e99i99
b06b99e99i99,b03b99e99i99,b03b99e99i99,b03b99e99i99,b06b99e99i99,b03b99e99i99,b06b99e99i99,b06b99e99i99,b03b99e99i99,b06b99e99i99,b03b99e13i99,b06b99e99i99
b03b99e99i99,b03b99e99i99,b03b99e99i99,b03b99e99i99,b06b99e99i99,b03b99e99i99,b03b99e99i99,b06b99e99i99,b03b99e99i99,b06b99e99i99,b03b99e99i99,b03b99e99i99
b06b99e99i99,b03b99e99i99,b03b99e99i99,b03b99e99i99,b06b99e99i99,b06b99e99i99,b03b99e99i99,b06b99e99i99,b03b99e99i99,b06b99e99i99,b03b99e99i99,b06b99e99i99
b06b99e99i99,b03b99e99i99,b03b99e99i99,b03b99e99i99,b03b99e99i99,b03b99e99i99,b03b99e99i99,b06b99e99i99,b03b99e99i99,b03b99e99i99,b03b99e99i99,b06b99e99i99
b06b99e99i99,b06b99e99i99,b06b99e99i99,b06b99e99i99,b06b99e99i99,b03b99e99i99,b03b99e99i99,b06b99e99i99,b06b99e99i99,b06b99e99i99,b06b99e99i99,b06b99e99i99
,,,,,,,,,,,
,FINISHED?,NO,,,,,,,,,