Door3,Door2,Door1,Door1,,,,,,,,
b03b99e15i99,b03b99e99i99,b03b99e99i99,b03b99e99i99,b03b99e99i99,b03b99e99i99,b03b99e99i99,b03b99e99i99,b03b99e99i99,b03b99e99i99,b03b99e99i99,b03b99e15i99
b03b99e99i99,b04b99e99i99,b03b99e99i99,b04b99e99i99,b03b99e99i99,b04b99e99i99,b04b99e99i99,b03b99e99i99,b04b99e99i99,b03b99e99i99,b04b99e99i99,b03b99e99i99
b03b99e99i99,b03b99e99i99,b03b99e99i99,b03b99e99i99,b03b99e99i99,b03b99e99i99,b03b99e99i99,b03b99e99i99,b03b99e99i99,b03b99e99i99,b03b99e99i99,b03b99e99i99
b03b99e99i99,b04b99e99i99,b03b99e99i99,b04b99e99i99,b03b99e99i99,b04b99e99i99,b04b99e99i99,b03b99e99i99,b04b99e99i99,b03b99e99i99,b04b99e99i99,b03b99e99i99
b03b99e99i99,b03b99e99i99,b03b99e99i99,b03b99e99i99,b03b99e99i99,b03b99e99i99,b03b99e99i99,b03b99e99i99,b03b99e99i99,b03b99e99i99,b03b99e99i99,b03b99e99i99
b03b99e99i99,b04b99e99i99,b03b99e99i99,b04b99e99i99,b03b99e99i99,b04b99e99i99,b04b99e99i99,b03b99e99i99,b04b99e99i99,b03b99e99i99,b04b99e99i99,b03b99e99i99
b03b99e15i99,b03b99e99i99,b03b99e99i99,b03b99e99i99,b03b99e99i99,b03b99e99i99,b03b99e99i99,b03b99e99i99,b03b99e99i03,b03b99e99i99,b03b99e99i99,b03b99e15i99
,,,,,,,,,,,
,FINISHED?,NO,,,,,,,,,